1 12 65 255 1472 16 0 
2 12 320 192 192 16 0 
3 12 1280 158 192 16 0 
4 12 832 190 128 16 0 
5 12 1216 63 128 16 0 
6 12 576 63 128 16 0 
7 12 704 128 64 16 0 
8 12 512 127 64 16 0 
9 40 1 51 576 16 0 
10 40 704 52 512 16 0 
11 40 1345 52 512 16 0
12 6 753 307 48 64 0 
