1 12 64 242 1472 16 1 
2 12 320 178 192 16 1 
3 12 1280 146 192 16 1 
4 12 832 178 128 16 1 
5 12 1216 50 128 16 1 
6 12 576 50 128 16 1 
7 12 512 114 64 16 1 
8 12 704 114 64 16 1 
9 12 1792 242 320 16 1 
10 12 2368 242 512 16 1 
11 12 2752 306 1024 16 1 
12 12 3200 178 448 16 1 
13 12 3456 50 384 16 1 
14 12 3008 146 128 16 1 
15 12 2816 50 192 16 1 
16 12 4352 178 192 16 1 
17 12 3712 242 448 16 1 
18 12 4096 305 320 16 1 
19 12 4096 306 320 16 1 
20 12 3840 114 128 16 1 
21 12 4032 114 128 16 1 
22 12 4480 242 128 16 1 
23 12 4672 178 128 16 1 
24 12 4928 242 128 16 1 
25 12 4992 306 128 16 1 
26 12 4224 146 64 16 1 
27 12 4672 50 64 16 1 
28 12 4992 50 64 16 1 
29 12 5056 146 64 16 1 
30 12 4736 114 192 16 1 
31 12 5440 50 192 16 1 
32 12 5184 242 128 16 1 
33 12 5696 114 128 16 1 
34 12 5888 178 128 16 1 
35 12 5248 178 320 16 1 
36 12 6016 242 256 16 1 
37 12 6080 146 192 16 1 
38 12 6272 179 64 16 1 
39 12 6336 114 64 16 1 
40 12 6272 178 64 16 1 
41 12 6016 50 448 16 1 
42 40 0 40 576 16 1 
43 40 704 40 512 16 1 
44 40 1344 40 1472 16 1 
45 7 1537 256 256 64 0 
46 7 2113 256 256 64 0 
47 40 3008 40 448 16 1 
48 51 639 188 64 64 0 
49 6 612 114 48 64 0 
50 -1 612 306 52 64 -1 
51 45 688 349 48 30 1 
52 6 1252 113 48 64 0 
53 2 1323 211 36 66 -1 
54 2 1363 211 36 66 -1 
55 -1 1574 305 52 64 -1 
56 11 2492 194 64 64 0 
57 46 2446 389 48 30 1 
58 6 2537 306 48 64 0 
59 2 2634 308 36 66 1 
60 2 2665 308 36 66 1 
61 2 2704 308 36 66 1 
62 2 3025 372 36 66 1 
63 2 3076 372 36 66 1 
64 2 3105 371 36 66 1 
65 49 3137 191 64 64 0 
66 11 3264 255 64 64 0 
67 2 3351 243 36 66 1 
68 2 3481 243 36 66 1 
69 2 3540 243 36 66 1 
70 2 3505 115 36 66 1 
71 2 3606 115 36 66 1 
72 11 3647 256 64 64 0 
73 2 3864 307 36 66 1 
74 1 4097 192 64 64 0 
75 1 4352 382 64 64 0 
76 2 4224 212 36 66 1 
77 45 4553 399 48 30 1 
78 43 4552 317 48 30 1 
79 53 4545 128 64 64 0 
80 6 4708 242 48 64 0 
81 1 5504 255 64 64 0 
82 11 5952 126 64 64 0 
83 11 6209 126 64 64 0 
84 6 6446 372 48 64 0 
85 12 6432 387 224 368 0 
86 19 6439 222 24 12 0 
87 19 6475 222 24 12 0 
88 6 3257 371 48 64 0 
89 23 2600 306 48 64 0 
90 23 2677 306 48 64 0 
91 23 3118 370 48 64 0 
92 26 6450 158 56 56 0 
93 18 6432 384 128 320 0 
