1 12 64 244 1472 16 1 
2 12 320 179 192 16 1 
3 12 1280 146 192 16 1 
4 12 832 178 128 16 1 
5 12 1216 51 128 16 1 
6 12 576 50 128 16 1 
7 12 512 114 64 16 1 
8 12 704 115 64 16 1 
9 40 1 40 576 16 1 
10 40 705 41 512 16 1 
11 40 1345 42 512 16 1 
12 7 1536 257 256 64 0 
13 6 879 308 48 64 0 
14 6 710 177 48 64 0 
15 6 520 178 48 64 0 
16 2 695 308 36 66 -1 
17 2 321 310 36 66 1 
18 2 397 245 36 66 1 
19 11 1279 128 64 64 0 
20 11 896 243 64 64 0 
21 4 509 442 48 30 1 
22 4 510 320 48 30 -1 
