1 12 63 242 1472 16 1 
2 12 320 178 192 16 1 
3 12 1280 146 192 16 1 
4 12 832 178 128 16 1 
5 12 1217 50 128 16 1 
6 12 577 50 128 16 1 
7 12 512 114 64 16 1 
8 12 704 114 64 16 1 
9 12 1792 242 320 16 1 
10 12 3200 178 448 16 1 
11 12 2368 242 512 16 1 
12 12 2816 50 192 16 1 
13 12 3008 146 128 16 1 
14 12 2752 306 1024 16 1 
15 12 3456 50 384 16 1 
16 12 3712 242 448 16 1 
17 12 4096 306 320 16 1 
18 12 3840 114 128 16 1 
19 12 4032 114 128 16 1 
20 12 4480 242 128 16 1 
21 12 4672 178 128 16 1 
22 12 4992 306 128 16 1 
23 12 4928 242 128 16 1 
24 12 5184 242 128 16 1 
25 12 4352 178 192 16 1 
26 12 4736 113 192 16 1 
27 12 4224 146 64 16 1 
28 12 4671 49 64 16 1 
29 12 4992 50 64 16 1 
30 12 5056 146 64 16 1 
31 12 6272 178 64 16 1 
32 12 6336 114 64 16 1 
33 12 5248 178 320 16 1 
34 12 6016 242 256 16 1 
35 12 6080 146 192 16 1 
36 12 5440 50 192 16 1 
37 12 5696 114 128 16 1 
38 12 5888 178 128 16 1 
39 12 6016 50 448 16 1 
40 40 1 44 576 16 1 
41 40 705 44 512 16 1 
42 40 1344 44 1472 16 1 
43 40 3008 45 448 16 1 
44 7 1536 256 256 64 0 
45 7 2112 256 256 64 0 
46 2 637 307 36 66 -1 
47 2 1326 212 36 66 -1 
48 2 1371 211 36 66 -1 
49 6 612 113 48 64 0 
50 6 1255 113 48 64 0 
51 45 553 347 48 30 1 
52 51 640 190 64 64 0 
53 2 1595 307 36 66 -1 
54 2 2369 305 36 66 -1 
55 2 2400 306 36 66 -1 
56 2 2435 306 36 66 -1 
57 6 2542 305 48 64 0 
58 46 2441 376 48 30 -1 
59 11 2493 192 64 64 0 
60 23 2651 303 48 64 0 
61 2 3020 370 36 66 -1 
62 2 3130 370 36 66 -1 
63 2 3164 370 36 66 -1 
64 23 3072 368 48 64 0 
65 49 3136 192 64 64 0 
66 11 3265 255 64 64 0 
67 2 3340 243 36 66 -1 
68 2 3481 243 36 66 -1 
69 2 3548 244 36 66 -1 
70 2 3522 114 36 66 -1 
71 2 3618 114 36 66 -1 
72 11 3647 255 64 64 0 
73 2 3863 306 36 66 -1 
74 1 4095 192 64 64 0 
75 2 4223 211 36 66 -1 
76 1 4353 384 64 64 0 
77 53 4543 128 64 64 0 
78 45 4556 406 48 30 1 
79 43 4557 307 48 30 1 
80 6 4721 240 48 64 0 
81 1 5504 256 64 64 0 
82 11 5953 125 64 64 0 
83 11 6209 127 64 64 0 
84 18 6432 390 224 368 0 
85 12 6463 114 192 16 1 
86 18 6432 372 224 368 0 
