1 12 63 255 64 32 0 
2 12 127 254 64 32 0 
3 12 189 254 64 32 0 
4 12 252 254 64 32 0 
5 12 317 256 64 32 0 
6 12 382 255 64 32 0 
7 12 446 254 64 32 0 
8 12 510 253 64 32 0 
9 12 573 254 64 32 0 
10 12 637 255 64 32 0 
14 12 513 114 64 32 0 
12 12 320 177 64 32 0 
13 12 383 177 64 32 0 
14 12 446 177 64 32 0 
15 12 576 51 64 32 0 
16 12 639 51 64 32 0 
17 12 705 116 64 32 0 
18 12 832 178 64 32 0 
19 12 896 178 64 32 0 
20 12 701 254 64 32 0 
21 12 766 255 64 32 0 
22 12 830 256 64 32 0 
23 12 893 254 64 32 0 
24 12 956 253 64 32 0 
25 12 1020 253 64 32 0 
26 12 1083 254 64 32 0 
27 12 1148 254 64 32 0 
28 12 1212 255 64 32 0 
29 12 1277 255 64 32 0 
30 12 1341 254 64 32 0 
31 12 1406 253 64 32 0 
32 12 1470 256 64 32 0 
34 12 1344 149 64 32 0 
35 12 1408 148 64 32 0 
36 12 1283 49 64 32 0 
37 12 1218 51 64 32 0 
37 12 1277 146 64 32 0 
38 7 1537 257 256 64 0 
39 40 512 50 64 32 0 
40 40 449 50 64 32 0 
41 40 385 49 64 32 0 
42 40 321 48 64 32 0 
43 40 256 49 64 32 0 
44 40 192 48 64 32 0 
45 40 129 48 64 32 0 
46 40 65 48 64 32 0 
47 40 705 51 64 32 0 
48 40 770 51 64 32 0 
49 40 833 50 64 32 0 
50 40 897 52 64 32 0 
51 11 701 222 64 64 0 