1 12 0 81 512 16 1 
2 12 320 145 192 16 1 
3 12 256 209 192 16 1 
4 12 319 338 192 16 1 
5 12 193 273 256 16 1 
6 12 1 339 256 16 1 
