1 12 0 84 512 16 1 
2 12 320 148 192 16 1 
3 12 320 340 192 16 1 
4 12 256 212 192 16 1 
5 12 127 531 192 16 1 
6 12 192 276 256 16 1 
7 12 0 340 256 16 1 
8 12 256 436 256 16 1 
9 12 0 595 256 16 1 
10 12 64 404 128 16 1 
11 12 1 468 128 16 1 
12 12 384 500 128 16 1 
13 12 384 724 128 16 1 
14 12 0 724 128 16 1 
15 12 64 884 128 16 1 
16 12 64 660 320 16 1 
17 12 256 820 256 16 1 
18 12 0 948 256 16 1 
19 12 64 820 64 16 1 
20 12 320 980 192 16 1 
21 12 0 1044 512 16 1 
22 12 0 1140 128 16 1 
23 12 64 1364 128 16 1 
24 12 64 1492 192 16 1 
25 12 0 1236 256 16 1 
26 12 256 1428 256 16 1 
27 12 128 1300 384 16 1 
28 12 1 1556 128 16 1 
29 12 384 1716 128 16 1 
30 12 0 1812 128 16 1 
31 12 64 1876 128 16 1 
32 12 0 1940 128 16 1 
33 12 0 1652 512 16 1 
34 12 320 1780 192 16 1 
35 12 256 1844 192 16 1 
36 12 64 2068 192 16 1 
37 12 320 2068 192 16 1 
38 12 0 2132 192 16 1 
39 12 384 1972 128 16 1 
40 12 256 2356 128 16 1 
41 12 320 2420 128 16 1 
42 12 256 2548 128 16 1 
43 12 320 2260 64 16 1 
44 12 0 2484 64 16 1 
45 12 384 2868 64 16 1 
46 12 128 2484 192 16 1 
47 12 64 2708 192 16 1 
48 12 128 2804 192 16 1 
49 12 319 2932 192 16 1 
50 12 64 2964 192 16 1 
51 12 1 3060 192 16 1 
52 12 384 2804 128 16 1 
53 12 128 2644 320 16 1 
54 12 384 3220 128 16 1 
55 12 320 3284 192 16 1 
56 12 193 3508 192 16 1 
57 12 320 3604 192 16 1 
58 12 1 3444 192 16 1 
59 12 256 3412 256 16 1 
60 12 1 3572 256 16 1 
61 12 1 3348 448 16 1 
62 12 64 3668 128 16 1 
63 12 256 3732 256 16 1 
64 12 0 3828 512 16 1 
65 12 0 3924 512 16 1 
66 2 17 531 36 66 1 
67 2 80 723 36 66 1 
68 2 277 724 36 66 -1 
69 49 256 641 64 64 0 
70 26 68 573 56 56 0 
71 26 388 700 56 56 0 
72 26 324 765 56 56 0 
73 26 134 826 56 56 0 
74 26 259 957 56 56 0 
75 50 257 895 64 64 0 
76 6 422 1106 48 64 0 
77 29 304 1199 31 64 0 
78 41 137 1429 48 30 -1 
79 45 332 1422 48 30 -1 
80 11 448 1603 64 64 0 
81 25 256 1683 32 32 0 
82 25 153 1682 32 32 0 
83 11 0 1920 64 64 0 
84 21 226 1979 64 64 0 
85 21 226 2204 64 64 0 
86 11 1 2336 64 64 0 
87 29 144 2384 31 64 0 
88 29 433 2609 31 64 0 
89 2 207 2548 36 66 -1 
90 2 305 2706 36 66 -1 
91 2 110 2773 36 66 -1 
92 53 321 2623 64 64 0 
93 11 447 2752 64 64 0 
94 11 0 2883 64 64 0 
95 11 64 3040 64 64 0 
96 1 418 3008 64 64 0 
97 51 1 2977 64 64 0 
98 21 259 3153 64 64 0 
99 2 17 3507 36 66 1 
100 2 101 3507 36 66 1 
101 6 45 3633 48 64 0 
102 34 256 4124 33 34 0 